type octile
height 43
width 63
map
@@@@@@@@@@@@@@@@@@@@@@@@@@@@@@@@@@@@@@@@@@@@@@@@@@@@@@@@@@@@@@@
@@@@@@@@@@@@@@@@@@@@@@@@@@@@@@@.@.@@@@@@@@@@.@@.@@@@@.@@.@@@@@@
@@@@@@@@@@@@@@@@@@@@@@@@@@@@@.............................@@@@@
@@@@@@@@@@@@@@@@@@@@@@@@@@@@@@.@@.@@@@@@@@@@.@@.@@@@@.@@.@@@@@@
@@@@@@@@@@@@@@@@@@@@@@@@@@@@@.....@@@@@@@@@@.@@.@@@@@.@@..@@@@@
@@.@@.@@@@@@@@@@@@@@@.@@.@@@@@.@@........................@@@@@@
@.................................@@@@@@@@@@.@@.@@@@@.@@..@@@@@
@@.@@.@@@@@@@@@@@@@@@.@@.@@@@@.@@..@@@@@@@@@.@@.@@@@@.@@.@@@@@@
@@.@@.@@@@@@@@@@@@@@@.@@.@@@@@.@@.@@@@@@@@@@.@@.@@@@......@@@@@
@..................................@@@@@@@@..@@..@@@@.@@.@@@@@@
@@.@@.@@@@@@@@@@@@@@@.@@.@@@@@.@@.@@@@@@@@@@.@@.@@@@@@@@@@@@@@@
@@.@@.@@@@@@@@@@@@@@@@@@@@@@@@.@@.@@@@@@@@@@.@@.@@@@@@@@@@@@@@@
@@.@@.@@@@@@@@@@@@@@@@@@@@@@@@.@@.@@@@@@@@@@.@@.@@@@@@@@@@@@@@@
@@.@@.@@@@@@@@@@@@@@@.@@.@@@@......@@@@@@@@..@@..@@@@@@@@@@@@@@
@@.@@.@@@@@@@@@@@@@@......@@@@.@@.@@@@@@@@@@.@@.@@@@@@@@@@@@@@@
@@.@@.@@@@@@@@@@@@@@@.@@.@@@@@.@@.@@@@@@@@@@.@@.@@@@@@@@@@@@@@@
@@.@@.@@@@@@@.@@@@@@@.@@.@@@@@.@@.@@@@.@@@@@.@@.@@@@.@@@@.@@.@@
@.............................................................@
@@.@@.@@@@@@@@@@@@@@@.@@.@@@@@.@@.@@@@@@@@@@.@@.@@@@@@@@@.@@.@@
@@.@@.@@@@@@@@@@@@@@@.@@.@@@@@.@@.@@@@@@@@@@.@@.@@@@@@@@@.@@.@@
@.............................................................@
@@.@@.@@@@@@@.@@@@@@@.@@.@@@@@.@@.@@@@.@@@@@.@@.@@@@.@@@@.@@.@@
@@.@@.@@@@@@@@@@@@@@@.@@.@@@@@.@@.@@@@@@@@@@.@@.@@@@@@@@@.@@.@@
@@.@@.@@@@@@@@@@@@@@@.@@.@@@@......@@@@@@@@......@@@@@@@......@
@@.@@.@@@@@@@@@@@@@@@.@@.@@@@@.@@.@@@@@@@@@@.@@.@@@@@@@@@.@@.@@
@@.@@.@@@@@@@@@@@@@@@.@@.@@@@@@@@@@@@@@@@@@@@@@@@@@@@@@@@@@@@@@
@@.@@.@@@@@@@@@@@@@@@.@@.@@@@@@@@@@@@@@@@@@@@@@@@@@@@@@@@@@@@@@
@@.@@.@@@@@@@@@@@@@@@.@@.@@@@@@@@@@@@@@@@@@@@@@@@@@@@@@@@@@@@@@
@..@@..@@@@@@@@@@@@@@.@@.@@.@@@@@@@@@@@@@@@@@@@@@@@@@@@@@@@@@@@
@@.@@.@@@@@@@@@@@@@@..@@.....@@@@@@@@@@@@@@@@@@@@@@@@@@@@@@@@@@
@@.@@.@@@@@@@@@@@@@@@.@@.@@.@@@@@@@@@@@@@@@@@@@@@@@@@@@@@@@@@@@
@@.@@.@@@@@@@@@@@@@@@.@@.@@.@@@@@@@@@@@@@@@@@@@@@@@@@@@@@@@@@@@
@@.@@.@@@@@@@@@@@@@@.........@@@@@@@@@@@@@@@@@@@@@@@@@@@@@@@@@@
@@.@@.@@@@@@@@@@@@@@@.@@.@@.@@@@@@@@@@@@@@@@@@@@@@@@@@@@@@@@@@@
@@.@@.@@@@@@@@@@@@@@@@@@@@@@@@@@@@@@@@@@@@@@@@@@@@@@@@@@@@@@@@@
@@.@@.@@@@@@@@@@@@@@@@@@@@@@@@@@@@@@@@@@@@@@@@@@@@@@@@@@@@@@@@@
@@.@@.@@@@@@@@@@@@@@@@@@@@@@@@@@@@@@@@@@@@@@@@@@@@@@@@@@@@@@@@@
@..........@@@@@@@@@@@@@@@@@@@@@@@@@@@@@@@@@@@@@@@@@@@@@@@@@@@@
@@.@@.@@@.@@@@@@@@@@@@@@@@@@@@@@@@@@@@@@@@@@@@@@@@@@@@@@@@@@@@@
@@..@..@...@@@@@@@@@@@@@@@@@@@@@@@@@@@@@@@@@@@@@@@@@@@@@@@@@@@@
@@.@@.@@@.@@@@@@@@@@@@@@@@@@@@@@@@@@@@@@@@@@@@@@@@@@@@@@@@@@@@@
@@.........@@@@@@@@@@@@@@@@@@@@@@@@@@@@@@@@@@@@@@@@@@@@@@@@@@@@
@@@@@@@@@@@@@@@@@@@@@@@@@@@@@@@@@@@@@@@@@@@@@@@@@@@@@@@@@@@@@@@